3 13 31
###############################
#p     ** *    *   *  * * *   #
# s b #*# # #*#*# # # #*#*#*# #
#  x*   3 ***  *      *   * * #
# # # # # #*# # #*#*# # # # #*#
#f ccccccc x **  *  *         #
# # # # # # # # # #*# #*# # # #
#*  *      *  *      *        #
# # # # #*# # # #*#*# # # # # #
#*    **  *       *           #
# #*# # # # # # #*# # # # # # #
#           *   *  *          #
###############################